lblQualityBroken = [2c2724](Сломаное) {0}[-]
lblQualityDamaged = [5b4538](Поврежденное) {0}[-]
lblQualityPoor = [ad773b](Плохое) {0}[-]
lblQualityAverage = [a6ad3b](Хорошее) {0}[-]
lblQualityGreat = [46ac3c](Отличное) {0}[-]
lblQualityFlawless = [3b5cad](Безупречное) {0}[-]
lblQualityLegendary = [863c9f](Легендарное) {0}[-]

stone = Большой Камень
dirt = Земля
clay = Глина
bedrock = Неразрушимый Камень
ice = Лед
beerCooler = Beverage Cooler
plainsGround = Plains Ground
fertileDirt = Земля
fertileGrass = Трава
gore = Gore
fertileFarmland = Fertile Farmland
copperOre = Медная Руда
burntForestGround = Burnt Forest Ground
forestGround = Forest Ground
destroyedStone = Destroyed Stone
terrainFiller = Terrain Filler
blueberry = Blueberry
potatoesSprout = Potatoes Sprout
potatoesYoung = Potatoes Young
cottenYoung = Cotten Young
plantedCotten = Planted Cotten
potatoes = Potatoes
blueberryYoung = Blueberries Young
coffeeSprout = Coffee Sprout
coffeeGrowing = Coffee Growing
plantedCornSeed = Planted corn Seed
gasPump = Gas Pump
storageAmmo = Storage Ammo
storageBuilding = Storage Building
storageExplosives = Storage Explosives
storageFood = Storage Food
storageHealth = Storage Health
storageWeapons = Storage Weapons
woodenHatch1_v1 = Wooden Hatch
denimPants = Blue Denim Pants
denimJacket = Denim Jacket
blackDenimPants = Black Denim Pants
brownDenimPants = Brown Denim Pants
redDenimPants = Red Denim Pants
plaidShirt = Plaid Shirt
plaidShirtRed = Red Plaid Shirt
plaidShirtBrown = Brown Plaid Shirt
plaidShirtGreen = Green Plaid Shirt
plaidShirtBlue = Blue Plaid Shirt
plaidShirtBlack = Black Plaid Shirt
tankTopBlue = Blue Tank Top
tankTopGreen = Green Tank Top
tankTopWhite = White Tank Top
tankTopRed = Red Tank Top
tankTopPurple = Purple Tank Top
scrapLegArmor = Scrap Leg Armor
scrapChestArmor = Scrap Chest Armor
clothBoots = Cloth Boots
scrapBoots = Scrap Boots
wornBoots = Worn Boots
macDyverBook = Книга "MacDyver"
bookcase = Bookcase
nailgun = Nailgun
nail = Nails
nail_Mold = Nail Mold
scrapHelmet = Scrap Helmet
tallow = Tallow
animalFat = Animal Fat
scrapGloves = Scrap Gloves
bioFuel = Biofuel
vegetableStew = Vegetable Stew
concreteMix = Concrete Mix
concreteForm = Concrete Form
concreteRampForm = Concrete Ramp Form
lootCrateShotgunMessiah = Shotgun Messiah Crate
lootCrateWorkingStiffs = Working Stiffs Crate
pillCase = Pill Case
beer = Beer
candle = Candle
vitamins = Vitamins
canMurkyWater = Can of Murky Water
forgeAheadBook = Forge Ahead Book
scrapMetalBlock = Scrap Metal Pile
barbedWireCrafted = Barbed Wire
bedRoll01_1 = Sleeping Bag
glass = Glass Pane
thinPlanksOld = Old Plywood
tallGrassDiagonal2 = Grass
tallGrassDiagonal3 = Grass
tallGrassDiagonal4 = Grass
brownGrassDiagonal = Grass
bushBirch = Birch Bush
bushMaple = Maple Bush
trunkBirch = Birch Wood
Trunk = Wood
tileIndustrial = Industrial Tile
eighthBlock = 1/8 Concrete Block
quarterBlock = 1/4 Concrete Block
halfBlockConcrete = 1/2 Concrete Block
halfBlockGravel = 1/2 Gravel Block
halfBlockConcreteAsphalt = 1/2 Asphalt Block
halfBlockMetalAsphalt = 1/2 Metal\Asphalt Block
halfBlockBrickMetal = 1/2 Brick\Metal Block
wedgeBrick = Brick Wedge
wedgeWoodWhiteShinglesOld = Old White Shingled Wood Wedge
wedgeBarnShingles = Barn Shingles Wedge
wedgeWoodWhiteShinglesAlsphalt = White Wood Shingles\Asphalt Wedge
wedgeBrick01Shingles = Brick01 Shingles Wedge
wedgeFlagstoneShingles = Flagstone Shingles Wedge
wedgeDrywallCeiling = Drywall\Ceiling Wedge
cornerWedgeConcrete = Concrete Wedge Corner
cornerHouseShinglesOld = Old House Shingles (Corner)
cornerHouseShinglesAsphalt = House Shingles\Asphalt
pyramidConcrete = Concrete Pyramid
flagstoneDrywall = Flagstone Drywall
brickTanBaseboard = Brick & Tan Baseboard
snow = Snow
snowTransition = Snow Transition
flagstoneDrywallBaseboard = Flagstone & Drywall Baseboard
sand = Sand
pyramidShinglesOld = Old Shingles Pyramid
pyramidShinglesAsphalt = Shingles & Asphalt Pyramid
pyramidShinglesWood = Wood Shingles Pyramid
concreteDistorted = Distorted Concrete
concreteTileGreen = Green Tile On Concrete
concreteTileBrown = Brown Tile On Concrete
cornerFullWedgeConcrete = Concrete Corner (Full Wedge)
cornerFullWedgeShinglesOld = Old Shingles Corner (Full Wedge)
cornerFullWedgeAsphaltShingles = Asphalt Shingles Corner (Full Wedge)
cornerFullWedgeShinglesWood = Wood Shingles & Asphalt (Full Wedge)
poleBlock = Pole Block
poleBlockOldWood = Old Wood (Pole Block)
poleBlockWoodPainted1 = Painted Wood 1 (Pole Block)
poleBlockPowerPole = Wood Fence Post
woodPainted3 = Painted Wood 3 (Pole Block)
poleBlockPlanks = Planks (Pole Block)
plateBlock = Plate (Block)
web = Cob Webs
plantCactus = Cactus
garageDoorCentered = Garage Door (Centered)
poleBlockWroughtIron = Wrought Iron (Pole Block)
wedgeWoodWhiteShinglesAsphalt = White Wood Shingles & Asphalt (Wedge)
wedgeWoodWhiteShinglesWood = Wooden White Shingles on Wood (Wedge)
branchMaple = Maple Branch
branchBirch = Birch Branch
wedgeAwning1 = Awning Wedge 1
wedgeAwning2 = Awning Wedge 2
Awning1 = Awning 1
Awning2 = Awning 2
logCabin = Log Cabin Wood
shinglesWood = Wood Shingles
wedgeCabinShingles = Wood Shingles (Wedge)
wedgeCabinShinglesWood = Cabin Shingles (Wood)
wedgeCabinOldWood = Cabin Old Wood (Wedge)
wedgeCabinFlagstone = Flagstone Cabin (Wedge)
wedgeHouseShinglesWood = Wood House Shingles (Wedge)
wedgeHouseShinglesAsphalt = House Shingles On Asphalt (Wedge)
wedgeHouseShinglesOld = Old House Shingles (Wedge)
wedgeHouseWoodWhite = White Wood House (Wedge)
metalRivet = Riveted Metal
WroughtIronMetal = Wrought Iron
CorregatedMetal = Iron Corrugated
wedgeMetalRivet = Riveted Metal (Wedge)
wedgeWroughtIron = Wrought Iron (Wedge)
curtain1 = Curtain 1
light = 1/8 Post Light
sidingBluePlasterBaseboard = Blue Plaster Baseboard Siding
sidingBluePlasterMiddle = Blue Plaster Siding (Middle)
sidingBluePlasterTop = Blue Plaster Siding (Top)
sidingBlueOldWood = Old Blue Wood Siding
sidingBlueWoodPaneling = Blue Wood Paneling
sidingGreenPlasterBaseboard = Green Plaster Baseboard & Siding
sidingGreenPlasterMiddle = Green Plaster Middle & Siding
sidingGreenPlasterTop = Green Plaster Top & Siding
sidingGreenPlasterOldWood = Green Plaster Old Wood & Siding
sidingGreenWoodPaneling = Green Plaster Wood Paneling & Siding
sidingWhiteBurnt = White Burnt Siding
sidingYellowPlasterBaseboard = Yellow Plaster Baseboard & Siding
sidingYellowPlasterMiddle = Yellow Plaster Middle & Siding
sidingYellowPlasterTop = Yellow Plaster Top & Siding
sidingYellowPlasterOldWood = Yellow Plaster OldWood & Siding
sidingYellowWoodPaneling = Yellow Plaster Wood Paneling & Siding
sidingTanPlasterBaseboard = Yellow Plaster Baseboard & Siding
sidingTanPlasterMiddle = Yellow Plaster Middle & Siding
sidingTanPlasterTop = Yellow Plaster Top & Siding
sidingTanPlasterOldWood = Yellow Plaster OldWood & Siding
sidingTanWoodPaneling = Yellow Plaster Wood Paneling & Siding
brickPlasterBaseboard = Brick Plaster Baseboard
brickPlasterMiddle = Brick Plaster Middle
brickPlasterTop = Brick Plaster Top
brickPlasterOldWood = Brick Plaster OldWood
brickWoodPaneling = Brick Plaster Wood Paneling
signarrowheadapache = Arrowhead & Apache
signaz260eastleft = 260 East (on left)
signaz260eastright = 260 East (on right)
signaz260eastspeed65 = 260 East (Limit 65)
signaz260west = 260 West
signaz260westleft = 260 West (on left)
signaz260westright = 260 West (on right)
signaz260westspeed65 = 260 West (Limit 65)
signaz73north = 73 North
signaz73northleft = 73 North (on left)
signaz73northright = 73 North (on right)
signaz73northspeed65 = 73 North (Limit 65)
signaz73south = 73 South
signaz73southleft = 73 South (on left)
signaz73southright = 73 South (on right)
signaz73southspeed65 = 73 South (Limit 65)
signbump = Bump
signcamping = Camping
signcampfish = Camping & Fishing
signdeadend = Dead End
signdeptagriculture = Dept. of Agriculture
signdestinationseast = Eastward Destinations
signdestinationswest = Westward Destinations
signdisabledparking = Disabled Parking
signdonotenter = Do Not Enter
signdonotenter2 = Do Not Enter
signhardhatarea = Hard Hat Area
signhighvoltage = High Voltage
signinfocenter = Information Center
signinfocenter2 = Inforomation Center
signkeepout = Keep Out
signkeepout2 = Keep Out
signlandfill = Landfill
signlandfill2 = Landfill
signleftonly = Left Turn Only
signmarkerred = Red Road Marker
signmarkeryellow = Yellow Road Marker
signmedicalleft = Medical Assistance (on left)
signmedicalright = Medical Assistance (on right)
signmilitaryrelief = Military Relief Zone
signmilitaryzone = Military Zone
signneighborhoodwatch = Neighborhood Watch Sign
signnotthru = Not A Thru Street
signnodumping = No Dumping
signnohazardouswaste = No Hazardous Waste
signnoparking = No Parking
signonewayleft = One Way (left)
signonewayleft2 = One Way (left)
signonewayright = One Way (right)
signonewayright2 = One Way (right)
signpedestrians = Pedestrian Crossing
signprivatenothru = Private Road (No Thru Traffic)
signprivateproperty = Private Property
signprivateproperty2 = Private Property (Vehicles Searched)
signprivateproperty3 = Private Property (Spanish)
signprivateproperty4 = Private Property (Bilingual)
signprohibidomuertes = Prohibido - Muertos Vivientes
signranger = Ranger Station
signrangerrestarea = Ranger Station & Rest Area
signrecycling1 = Recycling - Cardboard Only
signrecycling2 = Recycling - Cardboard Only - No Dumping
signrecycling3 = Recycling - Cardboard Only - No Dumping (bilingual)
signreliefzone = Military Relief Zone
signrightonly = Right Turn Only
signroadwork = Road Work Ahead
signroughsurface = Rough Surface Ahead
signschoolzone = School Zone
signslow = Slow
signspeed15 = Speed Limit 15
signspeed25 = Speed Limit 25
signspeed25notrucks - Speed Limit 25 (No Trucks)
signspeed35 = Speed Limit 35
signspeed45 = Speed Limit 45
signspeed55 = Speed Limit 55
signspeed65 = Speed Limit 65
signspeedtrucks25 = Trucks Speed Limit 25
signspeedtrucks55 = Trucks Speed Limit 55
signstop = Stop Sign
signstop4way = 4 Way Stop
signstopallway = All Way Stop
signstreetapacheaz260 = Apache St & AZ-260
signstreetapacheaz2602 = Apache St & AZ-260
signstreetbelllake = Bell Rd & Lake Rd
signstreetcoronado = Coronado Rd
signstreetcoronadoarrowhead = Coronado Rd & Arrowhead St
signstreetcoronadocourtland = Coronado Rd & Courtland St
signstreetcourtlandapache = Courtland St & Apache St
signstreetcourtlandaz260 = Courtland St & AZ-260
signstreetcourtlandaz2602 = Courtland St & AZ-260
signstreetcourtlandbell = Courtland St & Bell Rd
signstreetcourtlandhuenink = Courtland St & Huenink Rd
signstreetcourtlandmaple = Courtland St & Maple
signstreetcourtlandtran = Courtland St & Tran Rd
signstreetdavis = Davis Rd
signstreetessig = Essig Rd
signstreetlang = Lang Rd
signstreetlangtran = Lang Rd & Tran Rd
signstreetprivate = Private Rd
signstreettran = Tran Rd
signstreetusecrosswalk = Use Crosswalk
signyield = Yield Sign
signNationalPark = Navezgane National Park
signSpillwayLake = Spillway Lake
signAnselAdamsRiver = Ansel Adams River
signStreetMaple = Maple Rd
brickAsphalt = Brick Asphalt
stairsStone = Cobblestone Stairs
cobblestone = Cobblestone
graveStone1 = Tomb Stone

doorWooden = Wooden Door
doorScrapMetal = Scrap Iron Door
concreteSlope = Concrete Ramp
halfblockConcrete = Concrete Half Block
concrete = Concrete
concreteBlock = Concrete Bricks
storeShelving01TopDouble = Store Shelves Double (Top)
storeShelving01Top = Store Shelves (Top)
storeShelving01Double = Store Shelves Double
storeShelving01 = Store Shelves
officeChair01 = Office Chair
desk01 = Wooden Desk
desk02 = Iron Desk
chair01 = Old Chair
rebar = Iron Rebar
driftwood = Aged Wood
driftwood2 = Aged Wood
mattresshalf = Mattress Half
mattressFlat = Mattress
mattress = Mattress
bed01Frame = Iron Bed Frame
bed01 = An Old Bed
LitCampfire = Campfire
bedRoll01_2 = Sleeping Bag
corregatedMetalThin = Thin Corregated Iron
door = Wooden Door
doorRustyMetal = Rusty Iron Door
doorScrapMetal = Scrap Iron Door
doorWoodenOld = Old Wood Door
thinMetalPlate = Forging Iron
oldChair = Wooden Chair
oldWood = Old Wood
woodFenceOldFarm = Wood Farm Fence
sandStone = Sandstone
gravel = Gravel
cinderBlocks01 = Cinder Blocks
cinderBlocks02 = Cinder Blocks
cinderBlocks03 = Cinder Blocks
oilBarrel = Oil Barrel
desertGround = Desert Ground
brickDecayedAsphalt = Decayed Asphalt
brownGrassDiagonal3 = Brown Grass
thinPlanks = Plywood
asphalt = Asphalt
ironOre = Iron Ore
scrapMetalWall = Scrap Iron Wall
rustyGirderBeam = Rusty Girder Beam
barbedFence = Barbed Fence Wire
faucet02 = Household Faucet
faucet04 = Household Faucet
faucetBrass02 = Brass Faucet
faucetBrass02 = Brass Faucet

# Loot Containers
trashPile01 = Trash Pile
trashPile02 = Pile of Garbage
trashPile03 = Mound of Garbage
trashPile04 = Abandoned Rubbish
trashPile05 = Rotting Trash
trashPile06 = Spoiled Trash
trashPile07 = Garbage Pile
trashPile08 = Foul Trash
trashPile09 = Old Trash
cardboardBox = Cardboard Box
sportsBag01 = Rotting Sports Bag
sportsBag02 = Weathered Sports Bag
backpack01 = Weathered Backpack
backpack02 = Decomposing Backpack
backpack03 = Moldy Backpack
brick = Brick
leavesMaple3 = Maple Leaves
brownGrassDiagonal2 = Brown Grass
brownGrassDiagonal4 = Brown Grass
grass = Grass
brickDecayed = Decayed Brick
radiated = Radiated earth
farmField = dirt
brick = Brick
woodFloor01 = Wood Floor
cornerHouseShinglesWood = Corner House Shingles Wood
trunkPine = Wood Log
trunkBurnt = Burnt Wood
cabinetOldTop = Cupboard
cabinetOldBottom = Cupboard
duffle01 = Duffle Bag
purse01 = Purse
mailBox01 = Mail Box
mailBox02 = Mail Box
mailBox03 = Mail Box
treestump = Hollow Tree Stump
wallSafe = Wall Safe
deskSafe = Desk Safe
gunSafe = Gun Safe
airConditioner = Air Conditioner
corpseLoot01 = Corpse
fridge = Refrigerator

nightstand = Night Stand
trash_can01 = Trash Can
coffin_top = Coffin
coffin_bottom = Coffin
bin = Small Trash Bin
corpseLoot02 = Corpse
chest01 = Wooden Chest
medicineCabinet = Medicine Cabinet
cashRegister = Cash Register
cashRegisterEmpty = Empty Cash Register
shoppingCart = Shopping Cart
shoppingCartEmpty = Empty Shopping Cart
shoppingBasketEmpty = Empty Shopping Basket
shoppingBasket = Shopping Basket
casinoCoin = Duke's Casino Token

# Traps
trapSpikes01 = Wood Spikes
trapSpikesDamage01 = Weakened Wood Spikes
trapSpikesDamage02 = Damaged Wood Spikes
trapSpikesDamage03 = Broken Wood Spikes
trapSpikesDamage04 = Trashed Wood Spikes
trapSpikesDamage05 = Ruined Wood Spikes
mineCandyTin = Tin Land Mine
mineHubcap = Hub Cap Land Mine
mineAirFilter = Air Filter Land Mine

# Items
canBoiledWater = Консерва с Водой
wallTorch = Настенный Факел
candleWall = Настенная Свеча
makeshiftShotgun01 = Makeshift Shotgun
makeshiftShotgun01Clip = Makeshift Shotgun Clip
m136 = Ракетная Установка M-136 
m136Rocket = M-136 Ракета
handPlayer = Руки
handZombie = Руки Зомби
canBeef = Large Beef Ration
canChicken = Chicken Ration
canChili = Can of Chili
canHam = Can of Ham
canLamb = Lamb Ration
canMiso = Can of Miso
canPasta = Can of Pasta
canPeas = Can of Peas
canPears = Can of Pears
canSalmon = Can of Salmon
canSoup = Can of Soup
canStock = Can of Stock
canTuna = Can of Tuna
campfire = Костер
ladder = Деревянная Лестница
planks = Доски
cookingPot = Кастрюля
btnTakeAll = Взять Все
masonJar = Empty Mason Jar
animalRabbit = Заяц
toilet01 = Normal Toilet
toilet02 = Fancy Toilet
toilet03 = Commercial Toilet
plantYucca = Yucca Plant
brickTan = Brick with tan drywall
potatoPlant = Potato Plant
blueberrySprout = Blueberry Sprout
tallGrass = Tall Grass
treeHollowStump = Hollow Tree Stump
potassiumNitrate = Нитрат Калия
oven = Печь
planks4 = Red Wood Planks
sc_MeleeWeapons = Tools
sc_Food = Rations
sc_BuildingSupplies = Building Supplies
sc_RangedWeapons = Ranged Weapons
sc_RangedWeaponsDay5 = Ranged Weapons
sc_RangedWeaponsDay7 = Ranged Weapons
sc_Explosives = Explosives
sc_General = Supplies

goldenrod = Goldenrod Flower
animalHide = Шкура
leather = Кожа

leatherStrips = Коданные Полоски
metalStrips = Железные Полоски
shades = Очки
footballHelmet = Футбольный Шлем
ironHelmet = Железный Шлем
kevlarHelmet = Кевларовый Шлем
swatHelmet = S.W.A.T. Шлем
leatherHat = Кожанный Шлем
cowboyHat = Ковбойская Шляпа
ballCap = Бейсбольная Кепка
skullcap = Grey Skull Cap
skullCapRed = Red Skull Cap
skullCapBlue = Blue Skull Cap
skullCapGreen = Green Skull Cap
skullCapBrown = Brown Skull Cap
skullCapBlack = Black Skull Cap
nightvisionGoggles = Очки Ночного Видения
bandana = Бандана
bandanaRed = Красная Бандана
bandanaBlue = Синяя Бандана
bandanaGreen = Зеленая Бандана
bandanaBrown = Коричневая Бандана
bandanaBlack = Черная Бандана
clothShoes = Ботинки из Ткани
clothPants = Поножи из Ткани
clothJacket = Нагрудник из Ткани
clothHat = Шляпа
clothGloves = Перчатки
cottonSeed = Семена Хлопка
splint = Шина
bloodBag = Мешок для Переливания Крови
firstAidKit = Аптечка Первой Помощи
flare = Flare
gunPowderCharge = Gun Powder Charge
bloodDrawKit = набор для Переливания Крови
scrapIronFrame = Scrap Iron Frame
scrapIronRampFrame = Scrap Iron Ramp Frame
scrapIronInsideCornerFrame = Scrap Inner Cnr Frame
scrapIronOutsideCornerFrame = Scrap Outter Cnr Frame
secureDoorScrapMetal = Scrap Iron Secure Door
woodFrame = Wood Frame
woodRampFrame = Wood Ramp Frame
woodInsideCornerFrame = Wood Inner Cnr Frame
woodOutsideCornerFrame = Wood Outter Cnr Frame
secureDoorWooden = Secure Wood Door
rebarRampFrame = Rebar Ramp Frame
rebarFrame = Rebar Frame
wallOven = Wall Oven



# Loot container tooltip texts
lootTooltipNew = <{0}> Обыскать {1} (Не тронуто)
lootTooltipEmpty = Пустой {1}
lootTooltipTouched = <{0}> Обыскать {1}
lootEntity = <{0}> Обыскать {1}

# Item focused
itemTooltipFocusedOne = <{0}> Подобрать {1}
itemTooltipFocusedSeveral = <{0}> Подобрать {2}  {1}шт.

# Vehicles
car_Blue = Decayed Blue Sedan
car_Red = Decayed Red Sedan
car_Orange = Decayed Yellow Sedan
car_White = Decayed White Sedan

# Wildlife
animalStag = Олень
animalRabbit = Заяц
animalPig = Свинья
Boar = Кабан

# Zombie class names
zombie02 = Feral Walker
zombie04 = Infected Survivor
zombie05 = Reanimated Corpse
zombie06 = Nude Walker
zombie07 = Festering Corpse
zombiegal01 = Plagued Nurse
zombiegal02 = Infected Woman
zombiegal03 = Infected Lady
zombiegal04 = Decayed Cheerleader
fatzombie = Bloated Walker
fatzombiecop = Infected Police Officer
zombiedog = Zombie Dog
spiderzombie = Spider Zombie
snowzombie01 = Frigid Hunter
snowzombie02 = Frozen Lumberjack
snowzombie03 = Frostbitten Worker
zombiecrawler = Crawler
hornet = Hornet
burntzombie = Burn Victim


mp5_barrel = SMG Barrel
mp5_stock = SMG Stock
mp5_triggerHousing = SMG Receiver
mp5_barrel_mold = SMG Barrel Mold
mp5_stock_mold = SMG Stock Mold
mp5_triggerHousing_mold = SMG Receiver Mold


pistol_barrel = Pistol Barrel
pistol_slide = Pistol Slide
pistol_triggerHousing = Pistol Receiver
pistol_barrel_mold = Pistol Barrel Mold
pistol_slide_mold = Pistol Slide Mold
pistol_triggerHousing_mold = Pistol Receiver Mold

PumpShotgun_barrel = Shotgun Barrel
PumpShotgun_barrel_mold = Shotgun Barrel Mold
PumpShotgun_pump = Shotgun Pump
PumpShotgun_shortBarrel = Shotgun Short Barrel
PumpShotgun_shortStock = Shotgun Short Stock
PumpShotgun_stock = Pump Shotgun Stock
PumpShotgun_triggerHousing = Shotgun Receiver
PumpShotgun_triggerHousing_mold = Shotgun Receiver Mold
PumpShotgun_shortBarrel_mold = Shotgun Shrt Barrel Mold


sniperRifle_barrel_1 = Sniper Barrel
sniperRifle_barrel_1_mold = Sniper Barrel Mold

sniperRifle_barrel_2 = Sniper Handguard
sniperRifle_barrel_2_mold = Sniper Handguard Mold

sniperRifle_scopeFrame_mold = Sniper Scope Mold
sniperRifle_scopeFrame = Sniper Scope

sniperRifle_stock = Sniper Stock
sniperRifle_stock_mold = Sniper Stock Mold
sniperRifle_triggerHousing = Sniper Receiver
sniperRifle_triggerHousing_Mold = Sniper Receiver Mold


breakdownWeapon = Разобрать
repairWeapon = Починить

ttScrapMetalIron = Положите предмет в сетку крафта чтобы разобрать
ttScrapMetalLead = Положите предмет в сетку крафта чтобы разобрать
ttScrapMetalBrass = Положите предмет в сетку крафта чтобы разобрать
ttBreakdownWeapon = Положите предмет в выходную ячейку чтобы разобрать. 
ttRepairWeapon = Положите предмет и материал для его ремонта в сетку крафта.




suitcase = Suitcase
birdnest = Гнездо


munitionsBox = Munitions Box
ironBars = Iron Bars
weaponRepairKit = Набор для Ремонта
sunglasses = Солнечные Очки
44Magnum = 44 Magnum

goldenRodTea = Чай из Золотарника
glassWindowMold = Форма Стекла
huntingRifleBarrel = Hunting Rifle Barrel
huntingRifleBarrelMold  = Hunting Rifle Barrel Mold
huntingRifleStock = Hunting Rifle Stock
huntingRifleBolt = Hunting Rifle Bolt
huntingRifleBoltMold  = Hunting Rifle Bolt Mold
leatherBoots = Кожанные Ботинки
leatherPants = Кожанные Поножи
leatherJacket = Кожанный Нагрудник
ironBoots = Железные Ботинки
ironLegArmor = Железные Поножи
ironChestArmor = Железный Нагрудник
leatherGloves = Кожанные Перчатки
ironGloves = Железные Перчатки
eggboiled = Вареное Яйцо
gasMask = Противогаз
cornOnTheCob = Вареная Кукуруза
coffee = Кофе
coffeeBeans = Зерна Кофе
coffeePlant = Coffee Plant Beans
skullCap = Skull Cap
44MagBullet = Патрон .44 Magnum
antibiotics = Антибиотик
moldyBread = Заплесневелый Хлеб
44MagnumCylinder = 44 Magnum Cylinder
44MagnumFrame = 44 Magnum Frame
44MagnumGrip = 44 Magnum Grip
cigar = Сигара
cigarette = Сигарета
oil = Масло
huntingKnifeBook = Книга "Охотничьи Ножи"
pistolBook = Книга "Пистолеты"
urbanCombatBook = Книга "Бой в городе"
ammunitionNationBook = Книга "Национальные Боеприпасы"
reloadingWeeklyBook = Еженедельник "Перезарядка"
fileCabinet = File Cabinet
graniteSink = Sink
cabinetOldSink = Old Sink
forge = Плавильная Печь
leadOre = Свинцовая Руда
coalOre = Каменный Уголь
tungstenOre = Вольфрамовая Руда
44MagnumParts = 44 Magnum Parts
stairsWroughtIron = Iron Stairs
stairsMetalRivet = Metal Riveted Stairs
stairsSmallOldwood = Wooden Stairs
stairsConcrete = Concrete Stairs
woodPlank = Доски
stairsPlanks = Wood Stairs
oldWoodPillar = Wood Pillar
boardedWindows = Window Boards
reinforcedMetalSiding = Reinforced Metal Siding
steelDoor1_v1 = Hard Metal Door
secureStorageChest = Сундук

ironWall = Iron Wall
sectionalArm = Old Couch Arm
sectionalCorner = Old Couch Corner
sectionalMiddle = Old Couch Middle
secureGunSafe = Gun Safe
woodFence = Wood Fence
plantChrysanthemum = Crysanthemum
trunkPineTip = Wood Pillar Point
goldenrodSeed = Goldenrod Seed
painting01 = Painting Landscape
painting02 = Painting Lakehouse
keystone = Land Claim Block
barnWood = Barnwood
cabinet = Cabinet
cabinetTop = Cabinet Top
concreteReinforced = Reinforced Concrete
cornerFullWedgeAwning1 = Corner Wedge Awning 1
fridgeBottom = Fridge Bottom
hayBale = Hay Bale
sandbags = Sandbags
sectionalArm2 = Leather Couch Arm
sectionalCorner2 = Leather Couch Corner
sectionalMiddle2 = Leather Couch Middle
secureDoorTungsten = Secure Tungsten Door
stairsPavers = Brick Stairs
stairsSmallRichwood = Richwood Stairs
window01 = Wood Window
woodenStairs = Wood Stairs
woodShinglesCorner = Wood Shingles Corner

forgedIron = Кованное Железо
tnt = Динамит
baconAndEggs = Бекон и Яйца
goggles = Очки
grainAlcohol = Хлебный Спирт
homeMaintenanceBook = Книга "Сделай сам"
homeMaintenanceBookVolumeII = Книга "Сделай сам" Том 2
smgSchematics = Чертеж SMG
theEnforcerMagazine = Журнал "Блюститель закона"
ironFragment = Фрагмент Железа
cementMold = Форма Цемента
rottingFlesh = Гниющее Мясо
pineSeed = Семена Сосны
mapleSeed = Семена Клена

cobblestones = Булыжники
tubeConcrete = Concrete Pillar
metalTrussing = Metal Trussing
plant02 = Potted Plant
redWoodPillar = Richwood Pillar
brickPaver = Brick Paver
ladderMetal = Железная Лестница
trunkPineTip = Wood Log Spike
cutLog = Cut Log

cement = Цемент
leatherTanning = Книга "Кожевничество"
ironHelmetSchematic = Чертеж Железного Шлема
ironChestArmorSchematic = Чертеж Железного Нагрудника	
ironLegArmorSchematic = Чертеж Железных Понож	
ironBootsSchematic = Чертеж Железных Ботинок
ironGlovesSchematic = Чертеж Железных Перчаток
plantAloe = Aloe Vera Plant
shamSandwich = Старый Сэндвич
cobblestoneFrame = Cobblestone Frame
cobblestoneRampFrame = Cobblestone Ramp Frame
candleTable = Настольная Свеча

xmasPresent = Pimp Gift
santaHat = Шапка Санты


lblSpawnNearBedroll = Spawn near my bedroll
lblSpawnOnBedroll = Spawn on my bedroll

forgeInputIron = Iron
forgeInputLead = Lead
forgeInputGlass = Glass
forgeInputTungsten = Tungsten
forgeInputBrass = Brass
forgeInputStone = Stone

rock01 = Камушек
rock02 = Камушек
rock03 = Камушек
rock04 = Камушек
rock05 = Камушек
rock06 = Камушек
rock07 = Камушек
cotton = Хлопок
plantAloe = Алоэ




#wellness
wellnessIncreased = Самочувствие (+1): Здоровье и выносливость увеличины.
wellnessDecreased = Самочувствие (-1): Здоровье и выносливость снижены

#food water
notHungry = Вы не голодны.
notThirsty = Вы не хотите пить.




clubWood = Деревянная Дубина
clubIron = Железная Дубина
clubBarbed = Дубина с Колючкой
clubSpiked = Дубина с Шипами
stick = Палка
torch = Факел
hammer = Молоток
wrench = Гаечный Ключ
boneShiv = Костяная Заточка
femur = Большая Кость
huntingKnife = Охотничий Нож
Beretta_92 = Beretta 92
sawedOffPumpShotgun = Обрез
HK_MP-5SD3- HK MP-5SD3
12x70mm_Shell = Патрон 12x70mm
Remington_R11_RSASS = Remington R11 RSASS
chainsaw = Бнзопила
auger = Бур
ingotTungsten = Слиток Вольфрама
ingotCopper = Слиток Меди
ingotIron = Слиток Железа
ingotLead = Слиток Свинца
shortMetalPipe = Железная Трубка
ingotBrass = Слиток Латуни
foodYuccaFruit = Плод Юкки
foodYuccaJuice = Сок из Юкки
yuccaFibers = Волокно
canCatfood = Кошачьи Консервы
canDogfood = Собачьи Консервы
bottledWater = Банка Воды
canEmpty = Пустая Консерва
corn = Початок Кукурузы
paper = Бумага
book = Книга
venison = Оленина
emptyJar = Пустая Банка
cornSeed = Семена Кукурузы
potato = Картофель
potatoSeed = Семена Картофеля
blueberries = Черника
blueberrySeed = Семена Черники
blueberryPie = Черничный Пирог
Corn_Flour = Кукурузная Мука
cornBread = Кукурузный Хлеб
bakedPotato = Запеченый Картофль
bowl = Глиняная Миска
rabbit = Освежеванный Заяц
bucket = Ведро
bucketWater = Ведро Воды
firstAidBandage = Бактерицидный Бинт
aloeCream = Крем из Алоэ
coal= Уголь
clayLump = Комок Глины
bottledRiverWater = Банка Сырой Воды
gunPowder = Порох
cloth = Кусок Ткани
potassiumNitratePowder = Порошок Нитрата Калия
Rabbit_on_a_Stick = Заячье Мясо на палке
hubcap = Колесный Колпак
airFilter = Воздушныйы Фильтр
candyTin = Банка из под Конфет
painkillers = Обезбаливающее
pork = Свинина
porkCharred = Обугленная Свинина
rockSmall = Камушек
gasCan = Канистра с бензином
pipeBomb = Самодельная Бомба
crossbow = Деревянный Арбалет
crossbowBolt = Болты
foodHoney = Мед
Winchester_M1912 = Winchester M1912
woodenBow = Деревянный Лук
feather= Перо
egg = Перо
arrow = Стрела
Remington_700 = Remington 700
buckshot = Дробь
bandage = Бинт
bulletCasing = Гильза
bulletCasingMold = Форма Гильзы
9x19mm_Parabellum = 9x19mm Parabellum
10mm_Auto = 10mm Auto
7.62x51mm_NATO = 7.62x51mm NATO
IngotMoldIron = Форма Железного Слитка
IngotMoldCopper = Форма Медного Слитка
IngotMoldLead = Форма Свинцового Слитка
IngotMoldTungsten = Форма Вольфрамового Слитка
IngotMoldBrass = Форма Латунного Слитка
bulletTip = Пуля
scrapTungsten = Лом Вольфрама
bulletTipMold = Ворма Пули
doorKnob = Дверная Ручка
candleStick = Подсвечник
trophy = Латунный Кубок
radiator = Радиатор
fishingWeight = Рыбные Грузила
carBattery = Аккумулятор
scrapBrass = Лом Латуни
scrapIron = Металлолом
scrapLead = Лом Свинца
trophy2 = Свинцовый Кубок
trophy3 = Вольфрамовый Кубок
miningHelmet = Шахтерская Каска
venisonCharred = Обугленная Оленина
venisonGrilled = Жареная Оленина
venisonBoiled = Вареная Оленина
porkBoiled = Вареная Свинина
porkGrilled = Жареная Свинина
rabbitCharred = Обугленная Зайчатина
rabbitGrilled = Жареная Зайчатина
rabbitBoiled = Вареная Зайчатина
crushedSand = Мелкий Песок
cookingGrill = Гриль
beaker = Лабораторный Стакан
emptyJarMold = Форма Пустой Банки
brokenGlass = Осколки Стекла
Minigun = Миниган
Katana = Катана
Remington_R11_RSASS_no_Scope = Remington R11 RSASS без Прицела
44Magnum_with_Scope = .44 Magnum с Прицелом
Remington_700_with_Scope = Remington 700 с Прицелом
Fire_Crossbow = Огненный Арбалет
Explosion_Crossbow = Взрвной Арбалет
Crossbow_MIB = Железный Арбалет
Glock_17 = Glock 17
Glock_19 = Glock 17
Jericho_941 = Jericho 941
Jericho_941F = Jericho 941F
Desert_Eagle_Mark_VII = Desert Eagle Mark VII
Desert_Eagle_Mark_XIX = Desert Eagle Mark XIX
SIG-Sauer_P228 = SIG-Sauer P228
SIG-Sauer_P229 = SIG-Sauer P229
Five-seveN = Five-seveN
HK_USP_Compact = HK USP Compact
Benelli_M3_Super_90 = Benelli M3 Super 90
Benelli_XM1014 = Benelli XM1014
HK_MP-5K = HK MP-5K
IMI_UZI = IMI UZI
Mini_UZI = Mini UZI
Micro_UZI = Micro UZI
Uzi_Pro = Uzi Pro
Ingram_MAC_M10 = Ingram MAC M10
FN_P90  = FN P90 
IMI_Galil = IMI Galil
AK-47 = AK-47
AK-74 = AK-74
AKC-74Y = AKC-74Y
M16A1 = M16A1
Sig_550 = Sig 550
HK_G3 = HK G3
Steyr_AUG = Steyr AUG
SIG_SG_552 = SIG SG 552
M-249_SAW = M-249 SAW
AI_AWM_F_300WM = AI AWM F 300WM
Steyr_Scout = Steyr Scout
RPG-32_'HASHIM' = RPG-32 "HASHIM"
M202A1_'FLASH' = M202A1 "FLASH"
PG-32V_Rocket = Ракета PG-32V
M74_Rocket = Ракета M74
M79 = M79
EX-41 = EX-41
GL-06 = GL-06
Mk-1S_MGL = Mk-1S MGL
Flamethrower = Огнемет
Beretta_92_with_Muffler = Beretta 92 с Глушителем
Jericho_941_with_Muffler = Jericho 941 с Глушителем
HK_USP_Compact_with_Muffler = HK USP Compact с Глушителем
NapalmTank = Напалм
40x46mm_Granade = 40x46mm Граната
.357_SIG = .357 SIG
.50_Action_Express = .50 Action Express
5.45x39mm_Bullet = 5.45x39mm Патрон
5.56x45mm_NATO = 5.56x45mm NATO
5.7x28mm_Bullet = 5.7x28mm Патрон
7.62x39mm_Bullet = 7.62x39mm Патрон
8.6×70mm_Bullet = 8.6×70mm Патрон
Fire_Bolt = Огненный Болт
Explosion_Bolt = Взрывной Болт
Iron_Bolt  = Железный Болт 
Molotov = Коктель "Молотов"
F-1 = Граната Ф-1
RGD = Граната РГД
Iron_Shiv = Заточка
Finka = Финка
Cooking_Knife = Кухонный Нож
Straight-edge_Razor = Опасная Бритва
Butterfly_Knife = Нож Бабочка
Battle_Knife_'Cherry'  = Боевой Нож "Вишня"
Ka-Bar = Ка-Бар
Tanto  = Танто 
Khukuri = Кукри
Machete = Мачете
Shocking_Club = Электрическая Дубинка
Shocking_Spiked_Club = Электрическая Шипастая дубинка
Crowbar = Лом
stoneAxe = Каменный Топор
Stone_Pickaxe = Каменная Кирка
stoneShovel = Каменная Лопата
Stone_Hoe = Каменная Тяпка
Copper_Axe = Медный Топор
Copper_Pickaxe = Медная Кирка
Copper_Sledgehammer = Медная Кувалда
Copper_Shovel = Медная Лопата
Copper_Hoe = Медная Тяпка
fireaxe = Железный Топор
pickaxeIron = Железная Кирка
sledgehammer = Железная Кувалда
shovel = Железная Лопата
hoe = Железная Тяпка
Bronze_Axe = Бронзовый Топор
Bronze_Pickaxe = Бронзовая Кирка
Bronze_Sledgehammer = Бронзовая Кувалда
Bronze_Shovel = Бронзовая Лопата
Bronze_Hoe = Бронзовая Тяпка
Brass_Axe = Латунный Топор
Brass_Pickaxe = Латунная Кирка
Brass_Sledgehammer = Латунная Кувалда
Brass_Shovel = Латунная Лопата
Brass_Hoe = Латунная Тяпка
Steel_Axe = Стальной Топор
Steel_Pickaxe = Стальная Кирка
Steel_Sledgehammer = Стальная Кувалда
Steel_Shovel = Стальная Лопата
Steel_Hoe = Стальная Тяпка
Tungsten_Axe = Вольфрамовый Топор
Tungsten_Pickaxe = Вольфрамовая Кирка
Tungsten_Sledgehammer = Вольфрамовая Кувалда
Tungsten_Shovel = Вольфрамовая Лопата
Tungsten_Hoe = Вольфрамовая Тяпка
Fishing_Rod = Удочка
Fishing_Rod_With_Bail = Удочка с наживкой
Webgun = Паутиномет
Kvass = Квасс
Pork_Ration = Паек из Свинины
Venison_Ration = Паек из Оленины
Rabbit_Ration = Паек из Зайчатины
Fish_Ration = Паек из рыбы
Cornbread Snack Tin = Cornbread Snack Tin
Corn Cob Snack Tin = Corn Cob Snack Tin
Backed Potato Snack Tin = Backed Potato Snack Tin
Yucca Fruit Snack Tin = Yucca Fruit Snack Tin
Boiled Egg Snack Tin = Boiled Egg Snack Tin
Charred Pork Lunch = Charred Pork Lunch
Charred Venison Lunch = Charred Venison Lunch
Charred Rabbit Lunch = Charred Rabbit Lunch
Grilled Rabbit Lunch  = Grilled Rabbit Lunch 
Grilled Pork Lunch = Grilled Pork Lunch
Grilled Venison Lunch = Grilled Venison Lunch
Bacon And Eggs Lunch = Bacon And Eggs Lunch
Boiled Rabbit Lunch = Boiled Rabbit Lunch
Boiled Pork Lunch = Boiled Pork Lunch
Boiled Venison Lunch = Boiled Venison Lunch
Stewed Venison Lunch = Stewed Venison Lunch
Stewed Rabbit Lunch = Stewed Rabbit Lunch
Veggie Stew Lunch = Veggie Stew Lunch
Venison_on_a_Stick = Оленина на Палке
Pork_on_a_Stick = Свинина на Палке
Rabbit_on_a_Stick = Зайчатина на Палке
Venison_Kebab = Шашлык из Оленины
Pork_Kebab = Шашлык из Свинины
meatCookedStick = Шашлык из Зайчатины
Perch = Окунь
Bream = Лещ
Pike = Щука
Charred_Perch = Печеный Окунь
Charred_Bream = Печеный Лещ
Charred_Pike = Печеный Щука
Fresh-soup = Уха
Can_Boiled_Water_with_Egg = Консерва с яйцом
Blueberries_Vine  = Черничное Вино 
Blueberries_Compote = Черничный Компот
Sweet_GoldenRod_Tea = Сладкий Чай из Золотарника
Sweet_Coffee = Сладкий Кофе
Raw_Corn_Dough = Сырое Тесто
Corn_Dough_for_Baking = Тесто Для Выпечки
Pork_Stew = Тушеная Свинина
rabbitStew = Тушеная Зайчатина
venisonStew = Тушеная Оленина
Yeast = Дрожжи
Hop = Хмель
Cucumber = Огурец
Tomato = Помидор
Pickles = Маринованные Огурцы
Marinated_Tomatoes = Маринованные Помидоры
Raw_Rabbit_Stew = Сырая Тушеная Свинина
Raw_Pork_Stew = Сырая Тушеная Зайчатина
Raw_Venison_Stew = Сырая Тушеная Оленина
Sugar = Сахар
Flask = Фляга
Water_Flask(3/3) = Фляга с Водой(3/3)
Murky_Water_Flask(3/3) = Фляга с Сырой Водой(3/3)
Mead = Медовуха
Injector 88(0/4) = Иньектор 88(0/4)
Ampoule RED = Ампула КРАСНАЯ
Injector 88(4/4) RED = Иньектор 88(4/4) RED
Ampoule BLUE = Ампула СИНЯЯ
Injector 88(4/4) BLUE = Иньектор 88(4/4) BLUE
Caffeine_Pills = Кофеиновыее Таблетки
Absorbent_Carbon = Активированный Уголь
Salve = Мазь
Soap_Bar = Мыло
Napkin = Салфетка
AquaBriz = AquaBriz
Aquamira = Aquamira

Tank Top Black = Майка Черная
Tank Top Blue = Майка Синяя
Tank Top Pink = Майка Розовая
Tank Top Yellow = Майка Желтая
Tank Top Green = Майка Зеленая
Tank Top Aqua = Майка Аква
Tank Top Orange = Майка Оранжевая
Tank Top Yellow2 = Майка Желтоватая
Tank Top Red = Майка Красная
Tank Top Green2 = Майка Зеленоватая
Denim Pants White = Джинсы Белые
Denim Pants Aqua = Джинсы Аква
Denim Pants Yellow = Джинсы Желтые
Denim Pants Red = Джинсы Красные
Denim Pants Orange = Джинсы Оранжевые
Denim Pants Blue = Джинсы Синие
Denim Pants Pink = Джинсы Розовые
Denim Pants Green = Джинсы Зеленые
Plaid Shirt Red = Рубашка Красная
Plaid Shirt Blue = Рубашка Синяя
Plaid Shirt Aqua = Рубашка Аква
Plaid Shirt Green = Рубашка Зеленая
Plaid Shirt Yellow = Рубашка Желтая
Denim Jacket Yellow = Джинсовка Желтая
Denim Jacket Green = Джинсовка Зеленая
Denim Jacket Red = Джинсовка Красная
Denim Jacket Orange = Джинсовка Оранжевая
Cowboy Hat Brown = Коричнева Ковбойская Шляпа
Cowboy Hat Red = Красная Ковбойская Шляпа
Bandana Red = Бандана Красная
Bandana Green = Бандана Зеленая
Bandana Yellow = Бандана Желтая
Bandana Aqua = Бандана Аква
Bandana Blue = Бандана Синяя
Bandana Pink = Бандана Розовая
Armored Bandana = Бронированная Бандана
Reinforced Bandana = Усиленная Бандана
Straw_Hat = Панама
Plant_Fiber_Shirt = Рубашка из Травы
plantFiberPants = Штаны Из Травы
Getti = Обувь
Copper_Boots = Медные Ботинки
Copper_Leg_Armor = Медные Щитки
Copper_Chest_Armor = Медный Нагрудник
Copper_Helmet = Медный Шлем
Copper_Gloves = Медные Перчатки
Brass_Boots = Латунные Ботинки
Brass_Leg_Armor = Латунные Щитки
Brass_Chest_Armor = Латунный Нагрудник
Brass_Helmet  = Латунный Шлем 
Brass_Gloves = Латунные Перчатки
Steel_Boots = Стальные Ботинки
Steel_Leg_Armor = Стальные Щитки
Steel_Chest_Armor = Стальной Нагрудник
Steel_Helmet = Стальной Шлем
Steel_Gloves = Стальные Перчатки
Tungsten_Boots = Вольфрамовые Ботинки
Tungsten_Leg_Armor = Вольфрамовые Щитки
Tungsten_Chest_Armor = Вольфрамовый Нагрудник
Tungsten_Helmet = Вольфрамовый Шлем
Tungsten_Gloves = Вольфрамовые Перчатки
Iron_Helmet_With_Light = Железный Шлем с Фонариком
Copper_Helmet_With_Light = Медный Шлем с Фонариком
Brass_Helmet_With_Light = Латунный Шлем с Фонариком
Steel_Helmet_With_Light = Стальной Шлем с Фонариком
Tungsten_Helmet_With_Light = Вольфрамовый с Фонариком
Leather_Hat_With_Light = Кожанная Шляпа с Фонариком
Scrap_Zinc = Лом Цинка
Tin_Scrap = Лом Олова
Tin_Ingot = Слиток Олова
Scrap Copper = Лом Меди
Forged_Copper = Кованная Медь
Copper_Strips = Медные Полоски
Bronze_Blank = Бронзовая Болванка
Scrap Bronze = Лом Бронзы
Bronze_Ingot = Слиток Бронзы
Forged_Bronze = Кованная Бронза
Bronze_Strips = Бронзовые Полоски
Brass_Blank = Латунная Болванка
Forged_Brass = Кованная Латунь
Brass_Strips = Латунные Полоски
Steel_Blank = Стальная Болванка
Steel_Ingot = Слиток Стали
Forged_Steel = Кованная Сталь
Steel_Strips = Стальные Полоски
Forged_Tungsten = Кованный Вольфрам
Tungsten_Strips = Вольфрамовые Полоски
Muffler = Глушитель
Glue = Клей
Plastic_Bag = Пакет
Bone_Powder = Костная Мука
Rabbit_In_Plastic_Bag = Зайчатина в Пакете
Pork_In_Plastic_Bag = Свинина в Пакете
Venison_In_Plastic_Bag = Оленина в Пакете
Sewing_Kit = Швейный Набор
Aloe_Seed = Семена Алоэ
Yucca_Seed = Семена Юкки
Chrysanthemum_Seed = Семена Хризантемы
Cucumber_Seed = Семена Огурца
Tomato_Seed = Семена Помидора
EmptyNapalmTank = EmptyNapalmTank
Can_Empty_Mold = Форма Пустой Консервы
Steel_Ingot_Mold = Форма Стального Слитка
Bronze_Ingot_Mold = Форма Бронзового Слитка
Tin_Ingot_Mold = Форма Оловянного Слитка
Iron_Head_Mold = Форма Железного Наконеченика
Auger_Drill_Mold = Форма Сверла для Бура
Beaker_Mold = Форма Лабораторного Стакана
Candy_Tin_Mold = Форма Банки из под Конфет
Needle  = Игла 
Threads = Нитки
augerBlade = Сверло Бура
Chain_Saws = Цепь Бензопилы
Schematic Modification L1 = Чертеж Модификации L1
Empty_GasCan = Пустая Канистра
Bait  = Наживка 
Blade = Клинок
Handle = Рукоятка
Iron_Head = Железный Наконечник
Wood_Rot = Опилки
Bow Club Book = Книга "Арбалетный Клуб"
Ammunition Nation II Book = Книга "Национальные Боеприпасы" том 2
Simple Rockets Book = Книга "Простые Ракеты"
Water Mill Book = Книга "Ветряная Мельница"
Metal Alloys Book = Книга "Сплавы"
MacDyver II Book = Книга "MacDyver" том 2
Home Maintenance III Book = Книга "Сделай сам" том 3
Trap Hay = Ловушка под Сено
Trap Dirt = Ловушка под Землю
Trap Grass = Ловушка под Траву
Iron_Spikes = Железные Колья
Bucket_of_Acid = Ведро с Кислотой
Fire Trap = Огненная ловушка
Shock Trap = Электрическая Ловушка
Survivor_01 = Записка 01
Survivor_02 = Записка 02
Survivor_03 = Записка 03
Survivor_04 = Записка 04
Survivor_05 = Записка 05
Survivor_06 = Записка 06
Survivor_07 = Записка 07
Survivor_08 = Записка 08
Survivor_09 = Записка 09
Survivor_10 = Записка 10
Survivor_11 = Записка 11
Survivor_12 = Записка 12
Survivor_13 = Записка 13
Survivor_14 = Записка 14
Survivor_15 = Записка 15
Survivor_16 = Записка 16
Survivor_17 = Записка 17
Survivor_18 = Записка 18
Survivor_19 = Записка 19
Survivor_20 = Записка 20
Survivor_21 = Записка 21
Survivor_22 = Записка 22
Survivor_23 = Записка 23
Survivor_24 = Записка 24
Survivor_25 = Записка 25
Survivor_26 = Записка 26
Survivor_27 = Записка 27
Survivor_28 = Записка 28
Survivor_29 = Записка 29
Survivor_30 = Записка 30
Survivor_31 = Записка 31
Survivor_32 = Записка 32
Survivor_33 = Записка 33
Survivor_34 = Записка 34
Ore_Scanner(S) = Детектор Руды 1
Ore_Scanner(B) = Детектор Руды 2
Ore_Scanner(F) = Детектор Руды 3
Bat = Бита
Forck = Вилка
Pan = Сковородка
Screwdriver = Отвертка
Chemist_Beakers_Kit = Набор Лабораторных Стаканов
Mushroom_Soup = Грибной Суп
Fried_Mushrooms = Жаренные Грибы
Mushrooms_with_Potato = Грибы с Картошкой
Pickle_Soup = Рассольник
Grape = Виноград
Bowl_Murky_Water = Миска с Сырой Водой
Bowl_Water = Миска с Водой
Feedstuff = Комбикорм
Mushrooms_on_Stick = Грибы на Палке
Fried_Potato = Жареная Картошка
Boiled_Potato = Вареная Картошка
Bait_in_Box = Черви в Банке
Automatic Weapons Book = Книга "Автоматическое Оружие"
Automatic Weapons II Book = Книга "Автоматическое Оружие" том 2
M-249 SAW Schematic = Чертеж M-249 SAW
AI AWM F 300WM Schematic = Чертеж AI AWM F 300WM
Steyr Scout Schematic = Чертеж Steyr Scout
HK_MP-5SD3 = HK MP-5SD3